1111111
1E0E1C1
1ECC001
1ECC101
1ECE001
1ECE101
1EEP0C1
1111111